10 13 2 6
0 0 0 0 0 0 0 0 0 0 0 0 3
0 0 0 0 0 1 1 1 0 0 1 1 1
0 0 0 0 0 1 3 1 1 1 1 1 0
0 0 0 1 1 1 1 1 0 0 1 1 0
0 0 0 1 9 1 0 0 0 0 1 1 0
0 1 1 1 1 1 0 0 0 1 1 1 1
1 1 1 1 0 0 0 0 0 1 1 1 1
1 1 1 1 0 0 1 1 1 1 1 0 0
0 0 0 0 0 1 1 1 0 0 0 0 0
0 0 0 0 0 1 1 1 0 0 0 0 0
6 2 1 2 12
12 0 1 4 6
