9 15 2 3
0 0 0 0 0 0 0 6 0 0 0 0 0 0 0
1 1 4 1 0 0 0 1 0 0 0 0 0 0 0
1 1 1 1 1 0 0 1 0 0 0 0 0 0 0
1 4 1 1 1 1 1 1 0 0 1 1 0 0 1
1 1 1 1 1 0 0 0 1 0 0 0 1 0 0
1 1 4 1 0 0 0 0 1 0 0 0 1 0 0
1 0 0 0 0 0 0 0 6 0 0 1 1 1 0
1 0 0 0 0 0 0 0 0 0 1 1 9 1 0
1 0 0 3 0 0 0 0 0 0 1 1 1 1 0
1 3 2 3 8 3 9
2 1 4 3 12 3 13 8 1 8 2
2 5 4 3 12 3 13 8 1 8 2
7 0 2 3 8 3 9
8 6 4 3 12 3 13 8 1 8 2
3 8 1 4 5 0 0
