10 15 7 3
0 0 5 1 1 1 0 0 0 1 0 0 3 0 0 
0 0 0 0 0 1 0 0 0 1 0 0 0 0 0
0 0 0 0 0 1 1 1 1 1 0 0 0 0 0
3 0 0 1 1 1 1 1 1 1 1 1 0 0 3
0 0 0 0 0 1 1 1 1 1 0 0 0 0 0
0 0 0 0 0 0 1 0 0 1 0 0 0 0 0
0 0 0 0 0 0 1 0 0 1 1 1 5 0 0 
1 1 1 0 0 1 1 0 0 1 0 0 0 0 0
1 9 1 0 0 1 0 0 0 1 0 0 0 0 0
1 1 1 0 0 0 0 0 0 1 1 1 5 0 0 
2 0 0 2 6 10 6 11 2 0 10 0 11
12 0 0 0 2 5 5 6 5
12 6 0 0 2 3 1 3 2
12 9 0 6 0 3 0 4 0 10 0 11 6 10 6 11 2 3 12 3 13
14 3 0 0 1 9 3
0 3 0 2 9 10 9 11 2 8 3 8 4
