10 14 1 3
0 0 0 0 0 1 1 0 0 0 0 1 1 1
0 0 0 1 1 1 1 1 1 0 0 1 9 1
1 1 1 1 1 1 4 1 1 1 1 1 1 1
1 1 1 1 4 0 0 1 1 1 1 1 0 0
1 1 1 0 0 0 0 0 0 1 1 1 0 0
0 1 0 0 0 0 0 0 0 0 1 0 0 0
0 1 0 0 0 0 0 0 0 0 1 0 0 0
0 1 0 0 0 0 0 0 0 1 1 0 0 0
0 1 1 0 0 0 0 0 0 1 1 0 0 0
0 0 3 0 0 0 0 0 0 3 0 0 0 0
4 3 2 7 2 3 12
6 2 2 7 2 3 12
9 9 1 7 2 0 0
2 9 1 3 12 0 0
