10 14 1 7
0 0 1 1 0 0 0 0 0 0 0 0 0 0
0 0 1 1 1 0 0 0 0 0 0 0 0 0 
0 0 1 1 5 0 0 0 0 0 1 1 1 0 
0 0 0 1 1 1 1 0 0 0 1 9 1 0
0 0 0 0 0 0 1 1 0 0 1 1 1 0
0 1 1 0 0 0 1 1 0 0 0 0 0 0 
1 1 3 1 1 1 1 1 0 0 0 0 0 0
1 1 1 0 0 0 1 1 0 0 0 1 1 1
1 1 1 0 0 0 1 1 5 1 1 1 1 1
0 0 0 0 0 0 0 0 0 0 0 1 1 1
2 6 0 0 2 4 8 4 9
8 8 0 2 6 4 6 5 1 3 7
4 2 4 4 8 4 9 2 13 3 13 0 0
